@@@@@@@@@@@@@@@@
@..@...........@
@..@.....@.....@
@..@@@@@@@.....@
@.....@........@
@.....@........@
@..@......@@@@@@
@.........@....@
@@@@@@@...@....@
@...@......@...@
@...@..........@
@..............@
@.@@..@..@@@@@@@
@.@...@....@...@
@.@...@........@
@@@@@@@@@@@@@@@@
