@@@@@@@@@@@@@@@@
@..@...........@
@..@.....@.....@
@..@.....@.....@
@.....@........@
@..............@
@..@.........@@@
@..............@
@..............@
@...@......@...@
@...@..........@
@..............@
@.@@.....@@.@..@
@.@........@...@
@.@...@........@
@@@@@@@@@@@@@@@@